|111111111111111111111111111111111
|111111111111111111111111111111111
|111111111111111111111111111111111
|111111111111111111111111111111111
|111111000000011111111111111111111
|111111100000000000011111111111111
|111111100000000000011111111111111
|111111100000000000001111111111111
|111111000000000000001111111111111
|111111000000000000001111111111111
|111110000000000000011111111111111
|111111000000000000011111111111111
|111111000000000000111111111111111
|111111000000000000111111111111111
|111110000000000000111111111111111
|111110000000000000011111111111111
|111110000000000000011111111111111
|111110000000000000011111111111111
|111110000000000000111111111111111
|111111000000000000111111111111111
|111111000000000000111111111111111
|111111000000000000011111111111111
|111110000000000000011111111111111
|111111000000000000001111111111111
|111111000000000000001111111111111
|111111100000000000001111111111111
|111111100000000000011111111111111
|111111100000000000011111111111111
|111111000000011111111111111111111
|111111111111111111111111111111111
|111111111111111111111111111111111
|111111111111111111111111111111111
|111111111111111111111111111111111