border_size=1
usage=map

Wot         , Wot         , Wot         , Wot         , Wot         , Wot         , Wot         , Wot         , Wot         , Wot         , Wo          , Wog         , Xos         , Ch          , Ch          , Ch          , Ch          , Ch          , Ch          , Ch          , Xos         , Wog         , Wo          , Wot         , Wot         , Wot         , Wo          , Wog         , Xos         , Ch          , Ch          , Ch          , Ch          , Ch          , Ch          , Ch          , Xos         , Wog         , Wo          , Wot         , Wot         , Wot         , Wot         , Wot         , Wot         , Wot         , Wot         , Wot         , Wot         
Wot         , Wot         , Wot         , Wot         , Wot         , Wot         , Wot         , Wot         , Wot         , Wot         , Wo          , Wog         , Xos         , Ch          , Ch          , Kud         , Ch          , Ch          , Ch          , Ch          , Xol         , Wog         , Wo          , Wot         , Wot         , Wot         , Wo          , Wog         , Xol         , Ch          , Ch          , Ch          , Ch          , Kud         , Ch          , Ch          , Xos         , Wog         , Wo          , Wot         , Wot         , Wot         , Wot         , Wot         , Wot         , Wot         , Wot         , Wot         , Wot         
Wot         , Wot         , Wot         , Wot         , Wot         , Wot         , Wot         , Wot         , Wot         , Wot         , Wo          , Wog         , Xos         , Ch          , Ch          , Ch          , Ch          , Ch          , Rrc         , Rrc         , Xos         , Wog         , Wog         , Wo          , Wo          , Wo          , Wog         , Wog         , Xos         , Rrc         , Rrc         , Ch          , Ch          , Ch          , Ch          , Ch          , Xos         , Wog         , Wo          , Wot         , Wot         , Wot         , Wot         , Wot         , Wot         , Wot         , Wot         , Wot         , Wot         
Wot         , Wot         , Wot         , Wot         , Wot         , Wot         , Wot         , Wot         , Wot         , Wot         , Wo          , Wog         , Xol         , Rrc         , Rrc         , Ch          , Xol         , Xol         , Rrc         , Rrc         , Rrc         , Xos         , Xos         , Wog         , Wog         , Wog         , Xos         , Xos         , Rrc         , Rrc         , Rrc         , Xol         , Xol         , Ch          , Rrc         , Rrc         , Xol         , Wog         , Wo          , Wot         , Wot         , Wot         , Wot         , Wot         , Wot         , Wot         , Wot         , Wot         , Wot         
Wot         , Wot         , Wot         , Wot         , Wot         , Wot         , Wot         , Wot         , Wot         , Wot         , Wo          , Wog         , Xol         , Rrc         , Rrc         , Xol         , Rrc         , Rrc         , Rrc         , Rrc         , Rrc         , Rrc         , Rrc         , Xos         , Xos         , Xos         , Rrc         , Rrc         , Rrc         , Rrc         , Rrc         , Rrc         , Rrc         , Xol         , Rrc         , Rrc         , Xol         , Wo          , Wo          , Wot         , Wot         , Wot         , Wot         , Wot         , Wot         , Wot         , Wot         , Wot         , Wot         
Wot         , Wot         , Wot         , Wot         , Wot         , Wot         , Wot         , Wot         , Wo          , Wo          , Wog         , Wog         , Xol         , Rrc         , Rrc         , Xol         , Rrc         , Rrc         , Rrc         , Rrc         , Rrc         , Rrc         , Xol         , Xol         , Rrc         , Xol         , Xol         , Rrc         , Rrc         , Rrc         , Rrc         , Rrc         , Rrc         , Xol         , Rrc         , Rrc         , Xol         , Wog         , Wog         , Wo          , Wo          , Wot         , Wot         , Wot         , Wot         , Wot         , Wot         , Wot         , Wot         
Wot         , Wot         , Wot         , Wot         , Wot         , Wot         , Wo          , Wo          , Wog         , Wog         , Xol         , Xol         , Rrc         , Rrc         , Rrc         , Xol         , Rrc         , Rrc         , Rrc         , Rrc         , Xol         , Xol         , Rrc         , Rrc         , Rrc         , Rrc         , Rrc         , Xol         , Xol         , Rrc         , Rrc         , Rrc         , Rrc         , Xol         , Rrc         , Rrc         , Rrc         , Xol         , Xol         , Wog         , Wog         , Wo          , Wo          , Wot         , Wot         , Wot         , Wot         , Wot         , Wot         
Wot         , Wot         , Wot         , Wot         , Wo          , Wo          , Wog         , Wog         , Xol         , Xol         , Rrc         , Rrc         , Rrc         , Rrc         , Xol         , Xol         , Xol         , Rrc         , Xol         , Xol         , Rrc         , Rrc         , Rrc         , Rrc         , Rrc         , Rrc         , Rrc         , Rrc         , Rrc         , Xol         , Xol         , Rrc         , Xol         , Xol         , Xol         , Rrc         , Rrc         , Rrc         , Rrc         , Xol         , Xol         , Wog         , Wog         , Wo          , Wo          , Wot         , Wot         , Wot         , Wot         
Wot         , Wot         , Wo          , Wo          , Wog         , Wog         , Xol         , Xol         , Rrc         , Rrc         , Rrc         , Rrc         , Xol         , Xol         , Rrc         , Rrc         , Rrc         , Xol         , Xol         , Rrc         , Rrc         , Rrc         , Rrc         , Rrc         , Rrc         , Rrc         , Rrc         , Rrc         , Rrc         , Rrc         , Xol         , Xol         , Rrc         , Rrc         , Rrc         , Xol         , Xol         , Rrc         , Rrc         , Rrc         , Rrc         , Xol         , Xol         , Wog         , Wog         , Wo          , Wo          , Wot         , Wot         
Wot         , Wo          , Wo          , Wog         , Xol         , Xol         , Rrc         , Rrc         , Rrc         , Rrc         , Xol         , Xol         , Rrc         , Rrc         , Rrc         , Rrc         , Rrc         , Rrc         , Rrc         , Xol         , Xol         , Rrc         , Rrc         , Rrc         , Rrc         , Rrc         , Rrc         , Rrc         , Xol         , Xol         , Rrc         , Rrc         , Rrc         , Rrc         , Rrc         , Rrc         , Rrc         , Xol         , Xol         , Rrc         , Rrc         , Rrc         , Rrc         , Xol         , Xol         , Wog         , Wog         , Wo          , Wot         
Wot         , Wo          , Wog         , Xol         , Rrc         , Rrc         , Rrc         , Rrc         , Xol         , Xol         , Ch          , Ch          , Ch          , Rrc         , Rrc         , Rrc         , Rrc         , Rrc         , Rrc         , Rrc         , Rrc         , Xol         , Xol         , Rrc         , Rrc         , Rrc         , Xol         , Xol         , Rrc         , Rrc         , Rrc         , Rrc         , Rrc         , Rrc         , Rrc         , Rrc         , Ch          , Ch          , Ch          , Xol         , Xol         , Rrc         , Rrc         , Rrc         , Rrc         , Xol         , Wog         , Wo          , Wot         
Wot         , Wo          , Wog         , Xol         , Rrc         , Rrc         , Xol         , Xol         , Ch          , Ch          , 7 Kud       , Ch          , Ch          , Ch          , Ch          , Xol         , Xol         , Rrc         , Rrc         , Rrc         , Rrc         , Rrc         , Rrc         , Rrc         , Ch          , Rrc         , Rrc         , Rrc         , Rrc         , Rrc         , Rrc         , Rrc         , Xol         , Xol         , Ch          , Ch          , Ch          , Ch          , 8 Kud       , Ch          , Ch          , Xol         , Xol         , Rrc         , Rrc         , Xol         , Wog         , Wo          , Wot         
Wo          , Wo          , Wog         , Xol         , Rrc         , Rrc         , Ch          , Xol         , Xol         , Ch          , Ch          , Ch          , Xol         , Ch          , Ch          , Ch          , Ch          , Xol         , Xol         , Rrc         , Rrc         , Rrc         , Ch          , Ch          , Ch          , Ch          , Ch          , Rrc         , Rrc         , Rrc         , Xol         , Xol         , Ch          , Ch          , Ch          , Ch          , Xol         , Ch          , Ch          , Ch          , Xol         , Xol         , Ch          , Rrc         , Rrc         , Xol         , Wog         , Wo          , Wo          
Wo          , Wog         , Xol         , Xol         , Ch          , Ch          , Ch          , Ch          , Ch          , Xol         , Xol         , Xol         , Ch          , Ch          , Ch          , Ch          , Ch          , Ch          , Xol         , Xol         , Ch          , Ch          , Ch          , Ch          , Ch          , Ch          , Ch          , Ch          , Ch          , Xol         , Xol         , Ch          , Ch          , Ch          , Ch          , Ch          , Ch          , Xol         , Xol         , Xol         , Ch          , Ch          , Ch          , Ch          , Ch          , Xol         , Xol         , Wog         , Wo          
Wo          , Wog         , Xol         , Ch          , Ch          , Ch          , Ch          , Ch          , Ch          , Xol         , Ch          , Ch          , Ch          , Ch          , Ch          , Ch          , Xol         , Xol         , Ch          , Ch          , Ch          , Ch          , Ch          , Ch          , Ch          , Ch          , Ch          , Ch          , Ch          , Ch          , Ch          , Xol         , Xol         , Ch          , Ch          , Ch          , Ch          , Ch          , Ch          , Xol         , Ch          , Ch          , Ch          , Ch          , Ch          , Ch          , Xol         , Wog         , Wo          
Wo          , Wog         , Xol         , Ch          , Ch          , Ch          , Ch          , Ch          , Ch          , Xol         , Ch          , Ch          , Ch          , Ch          , Xol         , Xol         , Ch          , Ch          , Ch          , Ch          , Ch          , Ch          , Ch          , Ch          , Ch          , Ch          , Ch          , Ch          , Ch          , Ch          , Ch          , Ch          , Ch          , Xol         , Xol         , Ch          , Ch          , Ch          , Ch          , Xol         , Ch          , Ch          , Ch          , Ch          , Ch          , Ch          , Xol         , Wog         , Wo          
Wo          , Wog         , Xol         , Ch          , Ch          , 9 Kud       , Ch          , Ch          , Ch          , Xol         , Ch          , Ch          , Ch          , Xol         , Xol         , Ch          , Ch          , Ch          , Ch          , Ch          , Ch          , Ch          , Ch          , Ch          , Ch          , Ch          , Ch          , Ch          , Ch          , Ch          , Ch          , Ch          , Ch          , Ch          , Xol         , Xol         , Ch          , Ch          , Ch          , Xol         , Ch          , Ch          , Ch          , Kud         , Ch          , Ch          , Xol         , Wog         , Wo          
Wo          , Wog         , Xol         , Ch          , Ch          , Ch          , Ch          , Ch          , Ch          , Xol         , Ch          , Ch          , Ch          , Ch          , Ch          , Xol         , Xol         , Ch          , Ch          , Ch          , Ch          , Ch          , 2 Kud       , Ch          , Ch          , Ch          , 3 Kud       , Ch          , Ch          , Ch          , Ch          , Ch          , Xol         , Xol         , Ch          , Ch          , Ch          , Ch          , Ch          , Xol         , Ch          , Ch          , Ch          , Ch          , Ch          , Ch          , Xol         , Wog         , Wo          
Wo          , Wog         , Xol         , Ch          , Ch          , Ch          , Ch          , Ch          , Rrc         , Xol         , Xol         , Ch          , Ch          , Ch          , Ch          , Ch          , Ch          , Xol         , Xol         , Ch          , Ch          , Ch          , Ch          , Ch          , Ch          , Ch          , Ch          , Ch          , Ch          , Ch          , Xol         , Xol         , Ch          , Ch          , Ch          , Ch          , Ch          , Ch          , Xol         , Xol         , Rrc         , Ch          , Ch          , Ch          , Ch          , Ch          , Xol         , Wog         , Wo          
Wo          , Wog         , Wog         , Xol         , Xol         , Ch          , Xol         , Rrc         , Rrc         , Rrc         , Rrc         , Xol         , Rrc         , Ch          , Ch          , Ch          , Ch          , Ch          , Xol         , Xol         , Xol         , Ch          , Ch          , Ch          , Ch          , Ch          , Ch          , Ch          , Xol         , Xol         , Xol         , Ch          , Ch          , Ch          , Ch          , Ch          , Rrc         , Xol         , Rrc         , Rrc         , Rrc         , Rrc         , Xol         , Ch          , Xos         , Xos         , Wog         , Wog         , Wo          
Wot         , Wo          , Wo          , Wog         , Wog         , Xol         , Rrc         , Rrc         , Rrc         , Rrc         , Rrc         , Rrc         , Rrc         , Rrc         , Xol         , Ch          , Xol         , Xol         , Ch          , Ch          , Ch          , Xol         , Xol         , Ch          , Ch          , Ch          , Xol         , Xol         , Ch          , Ch          , Ch          , Xol         , Xol         , Ch          , Xol         , Rrc         , Rrc         , Rrc         , Rrc         , Rrc         , Rrc         , Rrc         , Rrc         , Xos         , Wog         , Wog         , Wo          , Wo          , Wot         
Wot         , Wot         , Wot         , Wo          , Wog         , Xos         , Rrc         , Rrc         , Rrc         , Rrc         , Rrc         , Rrc         , Rrc         , Rrc         , Xol         , Xol         , Ch          , Ch          , Ch          , Ch          , Ch          , Ch          , Ch          , Xol         , Xol         , Xol         , Ch          , Ch          , Ch          , Ch          , Ch          , Ch          , Ch          , Xol         , Xol         , Rrc         , Rrc         , Rrc         , Rrc         , Rrc         , Rrc         , Rrc         , Rrc         , Xos         , Wog         , Wo          , Wot         , Wot         , Wot         
Wot         , Wot         , Wot         , Wo          , Wog         , Xos         , Rrc         , Rrc         , Rrc         , Rrc         , Rrc         , Rrc         , Xol         , Xol         , Ch          , Ch          , Ch          , Ch          , Ch          , Ch          , Ch          , Ch          , Xol         , Xol         , Ch          , Xol         , Xol         , Ch          , Ch          , Ch          , Ch          , Ch          , Ch          , Ch          , Ch          , Xol         , Xol         , Rrc         , Rrc         , Rrc         , Rrc         , Rrc         , Rrc         , Xos         , Wog         , Wo          , Wot         , Wot         , Wot         
Wot         , Wot         , Wot         , Wo          , Wog         , Xos         , Rrc         , Rrc         , Rrc         , Rrc         , Rrc         , Xol         , Xol         , Ch          , Ch          , Ch          , Ch          , Ch          , Ch          , Ch          , Xol         , Xol         , Ch          , Ch          , Ch          , Ch          , Ch          , Xol         , Xol         , Ch          , Ch          , Ch          , Ch          , Ch          , Ch          , Ch          , Xol         , Xol         , Rrc         , Rrc         , Rrc         , Rrc         , Rrc         , Xos         , Wog         , Wo          , Wot         , Wot         , Wot         
Wot         , Wot         , Wo          , Wo          , Wog         , Xos         , Rrc         , Rrc         , Rrc         , Rrc         , Rrc         , Rrc         , Rrc         , Rrc         , Rrc         , Ch          , Ch          , Ch          , Xol         , Xol         , Ch          , Ch          , Ch          , Ch          , 4 Kud       , Ch          , Ch          , Ch          , Ch          , Xol         , Xol         , Ch          , Ch          , Ch          , Rrc         , Rrc         , Rrc         , Rrc         , Rrc         , Rrc         , Rrc         , Rrc         , Rrc         , Xos         , Wog         , Wo          , Wo          , Wot         , Wot         
Wo          , Wo          , Wog         , Wog         , Xol         , Xol         , Xol         , Rrc         , Rrc         , Rrc         , Rrc         , Rrc         , Rrc         , Rrc         , Rrc         , Xol         , Xol         , Xol         , Ch          , Ch          , Ch          , Ch          , Ch          , Ch          , Ch          , Ch          , Ch          , Ch          , Ch          , Ch          , Ch          , Xol         , Xol         , Xol         , Rrc         , Rrc         , Rrc         , Rrc         , Rrc         , Rrc         , Rrc         , Rrc         , Xol         , Xol         , Xol         , Wog         , Wog         , Wo          , Wo          
Wo          , Wog         , Xol         , Xol         , Ch          , Ch          , Ch          , Rrc         , Rrc         , Rrc         , Rrc         , Rrc         , Rrc         , Rrc         , Rrc         , Rrc         , Rrc         , Xol         , Xol         , Ch          , Ch          , Ch          , Ch          , Ch          , Ch          , Ch          , Ch          , Ch          , Ch          , Ch          , Xol         , Xol         , Rrc         , Rrc         , Rrc         , Rrc         , Rrc         , Rrc         , Rrc         , Rrc         , Rrc         , Rrc         , Ch          , Ch          , Ch          , Xol         , Xol         , Wog         , Wo          
Wo          , Wog         , Xol         , Ch          , Ch          , Ch          , Ch          , Ch          , Ch          , Xol         , Xol         , Rrc         , Rrc         , Rrc         , Rrc         , Rrc         , Rrc         , Rrc         , Rrc         , Rrc         , Rrc         , Ch          , Ch          , Ch          , Ch          , Ch          , Ch          , Ch          , Rrc         , Rrc         , Rrc         , Rrc         , Rrc         , Rrc         , Rrc         , Rrc         , Rrc         , Rrc         , Xol         , Xol         , Ch          , Ch          , Ch          , Ch          , Ch          , Ch          , Xol         , Wog         , Wo          
Wo          , Wog         , Xol         , Ch          , Ch          , Ch          , Ch          , Ch          , Ch          , Xos         , Ch          , Xol         , Xol         , Rrc         , Rrc         , Rrc         , Rrc         , Rrc         , Rrc         , Rrc         , Rrc         , Xol         , Xol         , Ch          , Ch          , Ch          , Xol         , Xol         , Rrc         , Rrc         , Rrc         , Rrc         , Rrc         , Rrc         , Rrc         , Rrc         , Xol         , Xol         , Ch          , Xol         , Ch          , Ch          , Ch          , Ch          , Ch          , Ch          , Xol         , Wog         , Wo          
Wo          , Wog         , Xol         , Ch          , Ch          , 5 Kud       , Ch          , Ch          , Ch          , Xos         , Ch          , Ch          , Ch          , Xol         , Xol         , Rrc         , Rrc         , Rrc         , Rrc         , Rrc         , Rrc         , Rrc         , Rrc         , Xol         , Xol         , Xol         , Rrc         , Rrc         , Rrc         , Rrc         , Rrc         , Rrc         , Rrc         , Rrc         , Xol         , Xol         , Ch          , Ch          , Ch          , Xol         , Ch          , Ch          , Ch          , 6 Kud       , Ch          , Ch          , Xol         , Wog         , Wo          
Wo          , Wog         , Xol         , Ch          , Ch          , Ch          , Ch          , Ch          , Ch          , Xos         , Ch          , Ch          , Ch          , Ch          , Ch          , Xol         , Xol         , Rrc         , Rrc         , Rrc         , Rrc         , Rrc         , Rrc         , Rrc         , Rrc         , Rrc         , Rrc         , Rrc         , Rrc         , Rrc         , Rrc         , Rrc         , Xol         , Xol         , Ch          , Ch          , Ch          , Ch          , Ch          , Xol         , Ch          , Ch          , Ch          , Ch          , Ch          , Ch          , Xol         , Wog         , Wo          
Wo          , Wog         , Xos         , Ch          , Ch          , Ch          , Ch          , Ch          , Xos         , Xos         , Xos         , Ch          , Ch          , Ch          , Ch          , Ch          , Ch          , Rrc         , Rrc         , Rrc         , Rrc         , Rrc         , Rrc         , Rrc         , Rrc         , Rrc         , Rrc         , Rrc         , Rrc         , Rrc         , Rrc         , Rrc         , Ch          , Ch          , Ch          , Ch          , Ch          , Ch          , Xos         , Xos         , Xos         , Ch          , Ch          , Ch          , Ch          , Ch          , Xos         , Wog         , Wo          
Wo          , Wog         , Wog         , Xos         , Xos         , Ch          , Xos         , Xos         , Wog         , Wog         , Wog         , Xos         , Xos         , Ch          , Ch          , Ch          , Ch          , Ch          , Ch          , Xol         , Xol         , Rrc         , Rrc         , Rrc         , Rrc         , Rrc         , Rrc         , Rrc         , Xol         , Xol         , Ch          , Ch          , Ch          , Ch          , Ch          , Ch          , Xos         , Xos         , Wog         , Wog         , Wog         , Xos         , Xos         , Ch          , Xos         , Xos         , Wog         , Wog         , Wo          
Wot         , Wo          , Wo          , Wog         , Wog         , Xos         , Wog         , Wog         , Wo          , Wo          , Wo          , Wog         , Wog         , Xos         , Xos         , Ch          , Ch          , Ch          , Ch          , Ch          , Ch          , Xol         , Xol         , Rrc         , Rrc         , Rrc         , Xol         , Xol         , Ch          , Ch          , Ch          , Ch          , Ch          , Ch          , Xos         , Xos         , Wog         , Wog         , Wo          , Wo          , Wo          , Wog         , Wog         , Xos         , Wog         , Wog         , Wo          , Wo          , Wot         
Wot         , Wot         , Wot         , Wo          , Wo          , Wog         , Wo          , Wo          , Wot         , Wot         , Wot         , Wo          , Wo          , Wog         , Wog         , Xos         , Xos         , Ch          , Ch          , Ch          , Ch          , Ch          , Xos         , Rrc         , Rrc         , Rrc         , Xos         , Ch          , Ch          , Ch          , Ch          , Ch          , Xos         , Xos         , Wog         , Wog         , Wo          , Wo          , Wot         , Wot         , Wot         , Wo          , Wo          , Wog         , Wo          , Wo          , Wot         , Wot         , Wot         
Wot         , Wot         , Wot         , Wot         , Wot         , Wo          , Wot         , Wot         , Wot         , Wot         , Wot         , Wot         , Wot         , Wo          , Wo          , Wog         , Wog         , Xos         , Xos         , Ch          , Ch          , Ch          , Xol         , Rrc         , Cud         , Rrc         , Xol         , Ch          , Ch          , Ch          , Xos         , Xos         , Wog         , Wog         , Wo          , Wo          , Wot         , Wot         , Wot         , Wot         , Wot         , Wot         , Wot         , Wo          , Wot         , Wot         , Wot         , Wot         , Wot         
Wot         , Wot         , Wot         , Wot         , Wot         , Wot         , Wot         , Wot         , Wot         , Wot         , Wot         , Wot         , Wot         , Wot         , Wot         , Wo          , Wo          , Wog         , Wog         , Xos         , Xol         , Xol         , Cud         , Cud         , Cud         , Cud         , Cud         , Xol         , Xol         , Xos         , Wog         , Wog         , Wo          , Wo          , Wot         , Wot         , Wot         , Wot         , Wot         , Wot         , Wot         , Wot         , Wot         , Wot         , Wot         , Wot         , Wot         , Wot         , Wo          
Wo          , Wot         , Wo          , Wot         , Wot         , Wot         , Wot         , Wot         , Wot         , Wot         , Wot         , Wot         , Wot         , Wot         , Wot         , Wot         , Wot         , Wo          , Wo          , Wog         , Xol         , Cud         , Cud         , Cud         , 1 Cud^Ii    , Cud         , Cud         , Cud         , Xol         , Wog         , Wo          , Wo          , Wot         , Wot         , Wot         , Wot         , Wot         , Wot         , Wot         , Wot         , Wot         , Wot         , Wot         , Wot         , Wot         , Wot         , Wot         , Wot         , Wot         
Wog         , Wo          , Wog         , Wo          , Wo          , Wot         , Wot         , Wot         , Wot         , Wot         , Wot         , Wot         , Wot         , Wot         , Wot         , Wot         , Wot         , Wot         , Wo          , Wog         , Xos         , Cud         , Cud         , Cud         , Cud         , Cud         , Cud         , Cud         , Xos         , Wog         , Wo          , Wot         , Wot         , Wot         , Wot         , Wot         , Wot         , Wot         , Wot         , Wot         , Wot         , Wot         , Wot         , Wot         , Wot         , Wot         , Wot         , Wot         , Wot         
Xos         , Wog         , Xos         , Wog         , Wog         , Wo          , Wo          , Wot         , Wot         , Wot         , Wot         , Wot         , Wot         , Wot         , Wot         , Wot         , Wot         , Wot         , Wo          , Wog         , Wog         , Xos         , Xos         , Cud         , Cud         , Cud         , Xos         , Xos         , Wog         , Wog         , Wot         , Wot         , Wot         , Wot         , Wot         , Wot         , Wot         , Wot         , Wot         , Wot         , Wot         , Wot         , Wot         , Wot         , Wot         , Wot         , Wot         , Wot         , Wot         
Ch          , Xos         , Ch          , Xos         , Xos         , Wog         , Wog         , Wo          , Wo          , Wot         , Wot         , Wot         , Wot         , Wot         , Wot         , Wot         , Wot         , Wot         , Wot         , Wo          , Wo          , Wog         , Xos         , Xos         , Xos         , Xos         , Xos         , Wog         , Wot         , Wot         , Wot         , Wot         , Wot         , Wot         , Wot         , Wot         , Wot         , Wot         , Wot         , Wot         , Wot         , Wot         , Wot         , Wot         , Wot         , Wot         , Wot         , Wot         , Wot         
Ch          , Ch          , Ch          , Ch          , Ch          , Xos         , Xos         , Wog         , Wog         , Wo          , Wo          , Wot         , Wot         , Wot         , Wot         , Wot         , Wot         , Wot         , Wot         , Wot         , Wo          , Wog         , Wog         , Wog         , Wog         , Wog         , Wog         , Wog         , Wot         , Wot         , Wot         , Wot         , Wot         , Wot         , Wot         , Wot         , Wot         , Wot         , Wot         , Wot         , Wo          , Wot         , Wot         , Wot         , Wot         , Wot         , Wot         , Wot         , Wot         
