border_size=1
usage=map

Gll^Fp      , Gll^Fp      , Gll^Fp      , Gll^Fp      , Gll^Fp      , Gll^Fp      , Gll^Fp      , Gll^Fp      , Gll^Fp      , Gll^Fp      , Gll^Fp      , Gll^Fp      , Gll^Fp      , Gll^Fp      , Gll^Fp      , Gll^Fp      , Gll^Fp      , Gll^Fp      , Gll^Fp      , Gll^Fp      , Gd^Fdf      , Gll^Fp      , Gll^Fp      
Gll^Fp      , Gll^Fp      , Gd^Fdf      , Gll^Fp      , Gll         , Gll^Fp      , Gll^Fp      , Gll^Fp      , Gll^Fp      , Gll^Fp      , Gll^Fp      , Gll^Fp      , Gll^Fp      , Gll^Fp      , Gll^Fp      , Gll^Fp      , Gll^Fp      , Gll^Fp      , Gll^Fp      , Gll^Fp      , Gd^Fdf      , Gll^Fp      , Gll^Fp      
Gll^Fp      , Gll^Fp      , Gll^Fp      , Gll^Fp      , Gll^Fp      , Gll         , Gll         , Gll         , Gll         , Gll^Fp      , Gll         , Gll^Fp      , Gll^Fp      , Gd^Fdf      , Gll^Fp      , Gll^Fp      , Gll^Fp      , Gd^Fdf      , Gd^Fdf      , Gll^Fp      , Gll^Fp      , Gd^Fdf      , Gll^Fp      
Gll^Fp      , Gll^Fp      , Gll^Fp      , Gll^Fp      , Gll^Fp      , Gll^Fp      , Gll^Fp      , Gll^Fp      , Gll^Fp      , Gll         , Gll         , Gll         , Gll         , Gll^Fp      , Gll^Fp      , Gll^Fp      , Gll^Fp      , Gll^Fp      , Gd^Fdf      , Gll^Fp      , Gll^Fp      , Gll^Fp      , Gll^Fp      
Gll         , Gll^Fp      , Gd^Fdf      , Gd^Fdf      , Gd^Fdf      , Gd^Fdf      , Gd^Fdf      , Gd^Fdf      , Gll         , Gll         , Gd^Fdf      , Gll^Fp      , Gll^Fp      , Gll         , Gll         , Gd^Fdf      , Gd^Fdf      , Gll^Fp      , Gd^Fdf      , Gll^Fp      , Gd^Fdf      , Gll^Fp      , Gll         
Gll^Fp      , Gll         , Gll^Fp      , Gd^Fdf      , Gll^Fp      , Gd^Fdf      , Gll         , Gll         , Gll^Fp      , Gd^Fdf      , Gll^Fp      , Gd^Fdf      , Gd^Fdf      , Gd^Fdf      , Gll         , Gll         , Gll^Fp      , Gd^Fdf      , Gd^Fdf      , Gd^Fdf      , Gll^Fp      , Gd^Fdf      , Gll^Fp      
Gll^Fp      , Gll^Fp      , Gll^Fp      , Gll^Fp      , Gll^Fp      , Gll^Fp      , Gll         , Gll^Fp      , Gd^Fdf      , Gll^Fp      , Gll^Fp      , Gll^Fp      , Gll^Fp      , Gll^Fp      , Gll         , Gll         , Gll^Fp      , Gll^Fp      , Gll^Fp      , Gll^Fp      , Gll^Fp      , Gll^Fp      , Gll^Fp      
Gll         , Gd^Fdf      , Gll^Fp      , Gd^Fdf      , Gd^Fdf      , Gll^Fp      , Gll         , Gll^Fp      , Gll^Fp      , Gd^Fdf      , Gd^Fdf      , Gd          , Gd^Fdf      , Gd^Fdf      , Gll^Fp      , Gll         , Gll         , Gd^Fdf      , Gd^Fdf      , Gd          , Gd^Fdf      , Gd          , Gd^Fdf      
Gd^Fdf      , Gd^Fdf      , Gd^Fdf      , Gd^Fdf      , Gd          , Gd          , Gd^Fdf      , Gd^Fdf      , Gd^Fdf      , Gd^Fdf      , Gd^Fdf      , Gd^Fdf      , Gll^Fp      , Gd^Fdf      , Gd^Fdf      , Gll         , Gd          , Gll^Fp      , Gll^Fp      , Gd^Fdf      , Gd          , Gll^Fp      , Gd^Fdf      
Gll^Fp      , Gll^Fp      , Gll^Fp      , Gll^Fp      , Gll         , Gll^Fp      , Gll^Fp      , Gll^Fp      , Gd^Fdf      , Gll^Fp      , Gll^Fp      , Gd^Fdf      , Gll^Fp      , Gd^Fdf      , Gll^Fp      , Gll         , Gd          , Gll^Fp      , Gll^Fp      , Gll^Fp      , Gd^Fdf      , Gll^Fp      , Gll^Fp      
Gll^Fp      , Gd^Fdf      , Gll^Fp      , Gll         , Gll^Fp      , Gd^Fdf      , Gll         , Gll^Fp      , Gd^Fdf      , Gll^Fp      , Gll^Fp      , Gll^Fp      , Gll^Fp      , Gll^Fp      , Gll^Fp      , Chr         , Chr         , Gd          , Gll^Fp      , Gd^Fdf      , Gll^Fp      , Gll^Fp      , Gll^Fp      
Gll^Fp      , Gd^Fdf      , Gll^Fp      , Gll         , Gll         , Gd^Fdf      , Gd^Fdf      , Gd^Fdf      , Gd^Fdf      , Gll^Fp      , Gll^Fp      , Gll^Fp      , Gd^Fdf      , Gd^Fdf      , Gd^Fdf      , Gd          , Khr         , Gd          , Gll^Fp      , Gll^Fp      , Gll^Fp      , Gll^Fp      , Gll^Fp      
Gll^Fp      , Gll^Fp      , Gll         , Gll         , Gll^Fp      , Gd^Fdf      , Gll         , Gll^Fp      , Gll^Fp      , Gd^Fdf      , Gd^Fdf      , Gd          , Gd^Fdf      , Gd^Fdf      , Gd^Fdf      , Gd^Fdf      , Gll^Fp      , Gll         , Gd          , Gd^Fdf      , Gll^Fp      , Gd^Fdf      , Gll^Fp      
Gll^Fp      , Gll^Fp      , Gll         , Gll^Fp      , Gll^Fp      , Gll^Fp      , Gll^Fp      , Gd^Fdf      , Gd^Fdf      , Gd          , Gd^Fdf      , Gll^Fp      , Gd^Fdf      , Gll^Fp      , Gll^Fp      , Gll^Fp      , Gll^Fp      , Gll^Fp      , Gll^Fp      , Gll         , Gll         , Gll^Fp      , Gd^Fdf      
Gll         , Gll         , Gll^Fp      , Gd^Fdf      , Gll^Fp      , Gd^Fdf      , Gd^Fdf      , Gll^Fp      , Gll^Fp      , Gll^Fp      , Gll^Fp      , Gll^Fp      , Gll^Fp      , Gll^Fp      , Gd^Fdf      , Gll^Fp      , Gll^Fp      , Gd^Fdf      , Gll^Fp      , Gll^Fp      , Gll^Fp      , Gll         , Gll^Fp      
